****************
*   *          *
*   ****       *
*   S  *  E    *
*  *****       *
*              *
*              *
****************